**************************************************************
*                                                            *
*          ***************   ********* *********    *******  *
*          ********          ********* *********          *  *
*          ******** ******   ********* *********          *  *
******************* ******                ****            *  *
*    *                                    ****  *         *  *
*    *                 *******  ******    ****  *         *  *
*    *         *       *             *    ****  *            *
*              *       *             *    ****  *            *
*    *         *       *             *          *            *
*    *         *       *             ******** ***            *
*    *         *       ***************          *            *
******         *              *                 *   ******  **
*                         ********   ************   *        *
*    *    ***************                           *        *
*    *    ***************  *************  ***********        *
*                                                   *        *
*    *                                              *        *
**************************************************************
