************************************************************
*  ********                   ***********                ***
*  *******   ***** **********       *****    **          ***
**   ***    ****** **********       *****    **  ******  ***
****  **** *******        ***       *****        ******  ***
*****  **   ******        ********* ***********  ****    ***
******     *******        ********* ***********  ******  ***
******************        *********          **********    *
****************** ***************  ********  *********  ***
*     ************ **************  ***** ****  ******    ***
* *** ************ *************  ****** *****  *******  ***
* ***              ************  *******         ******    *
* ****************************  ****************  *****  ***
* *********** ***********      ****     *********  ***   ***
* *********** *********** *********     *********       ****
* *********** *********** *********** ***********  *********
*                                                  *********
************************************************************
